-9
9
-4
6
0000000000000000000
0000000000111111100
0000000000111111100
1000000000111111100
0000000000111111100
0000000000111111100
0000000000111111100
0000000010111111100
0000000000000000000
0001000000000000000
0000000000000000010
